10
.B########
........#.
#######.#.
#.......#.
#######.#.
#.......#.
#######.#.
#.#.#E....
#.#.###.#.
#.......#.
